2	2	2	2	2	2	2	49	54	54	54	50	2
2	2	2	2	2	2	49	7	1	1	1	19	50
2	49	8	9	10	8	6	29	21	21	34	1	56
49	7	1	1	1	1	31	51	2	2	25	1	56
53	1	45	23	23	23	54	54	54	54	46	1	56
52	43	1	1	1	1	1	1	1	1	1	31	51
2	52	20	21	21	21	22	55	55	55	55	51	2